R -1000, -1000
F 220,100,0
C 225,30,0
EA textures/wall_1.xpm
WE textures/wall_2.xpm
SO textures/wall_3.xpm
NO textures/wall_4.xpm

111111111111111111111111
100000000000000000000001
100000000000000000000001
100000000000000000000011
100000222220000303030001
100000200020000000000001
100000200020000300030001
100000200020000000000001
100000220220000303030001
100000000000000000000001
100000000000000000000001
100000000000000700000001
100000000000000000000001
1000000N0010000000000001
100000000000000000000001
100000000000000000000001
144444444000500000000001
140400004000500006000001
140000504000500000000001
140400004000500000000001
140444444000500006000001
140000000000500000000001
144444444000000000000001
111111111111111111111111
