R 1920 1080
NO ./textures/wall_1.xpm

F 220,100,0
C 225,30,0
S ./textures/sprite_2.xpm

        1111111111111111111111111
        1000000011000000000000001
        1011000111000500000200001
        1001000000000500000W00001
111111111011001110000500000000001
100000000011000110000000111111111
11110111111111101100000001001
11110111111111101101010001001
11000000000100000011000001001
10000002000000000011000001001
10000000000000000001100001001
11000000111000010111110111001
111101111 11000101 1000001001
111111111 11111111 1111111111
